16,8
Outside.png
OutsideA.scr
-63, -63, -91, -90, -90, -90, -92, -63, -63, -63, -63, -63, -63, -63, -63, -63
-63, -63, -82, -81, -80, -81, -83, -63, -63, -63, -63, -63, -63, -63, -63, -63
 42,  42, -72, -70,  71, -70, -73,  42,  42,  42,  42,  42,  42,  42,  42,  42
 13,  20,  11,  11,  11,  11,  11,  11,  11,  11,  11,  11,  11,  11,  21,  13
 13,  03,  30,  12,  12,  12,  31,  30,  12,  12,  12,  12,  12,  31,  10,  13
 13,  03,  10,  13,  13,  13,  03,  10,  93,  50,  50,  50,  A0,  03,  10,  13
 13,  03,  32,  11,  11,  11,  33,  10,  13,  13,  13,  13,  13,  03,  10,  13
 13,  03,  30,  12,  12,  12,  12,  23,  13,  13,  13,  13,  13,  03,  10,  13