12,5
TestMap.png
TestScript.scr
-01, -02, -02, -10, -30, -30, -30, -30, -01, -02, -02, -10
-11,  00,  00, -32, -02, -02, -02, -02, -40,  00,  00, -12
-11,  00,  00,  00,  00,  00,  00,  00,  00,  00,  31, -12
-11,  00,  00, -41, -21, -21, -21, -21, -42,  00,  00, -12
-20, -21, -21, -22, -30, -30, -30, -30, -20, -21, -21, -22